




   CDDE
           CDDE                                                                                                                                          BBBBBBB
                                                                                                                                   CDDDDDDDDDDDDE         AAAAAA
                  CDDDE                                                                                                                                    AAAAA
                                                                                                                                                            AAAA
            BBBB                                                                                                                                             AAA
           BAAAAB                                                                                                         BBBBBBBBBBBBBBBBBBBBBBBBBBBBBBBBBBAAAA   
         BBAAAAAABB                                                                                          CDDDDDDDE    AAAAAAAAAAAAAAAAAAAAAAAAAAAAAAAAAAAAAA
  *    BBAAAAAAAAAABB                                                                           CDDDDDDDE                 AAAAAAAAAAAAAAAAAAAAAAAAAAAAAAAAAAAAAA
BBBBBBBAAAAAAAAAAAAAABBBBBBBBBBBBBBBBBBBBB           BBBBBBBBB       BBBBBBBBBBBB     BBBBBB                              AAAAAAAAAAAAAAAAAAAAAAAAAAAAAAAAAAAAAA
AAAAAAAAAAAAAAAAAAAAAAAAAAAAAAAAAAAAAAAAAA           AAAAAAAAA     BBAAAAAAAAAAAA     AAAAAA                              AAAAAAAAAAAAAAAAAAAAAAAAAAAAAAAAAAAAAA                                                                                                  
AAAAAAAAAAAAAAAAAAAAAAAAAAAAAAAAAAAAAAAAAA        BBBAAAAAAAAA       AAAAAAAAAAAA    BAAAAAA                              AAAAAAAAAAAAAAAAAAAAAAAAAAAAAAAAAAAAAA
AAAAAAAAAAAAAAAAAAAAAAAAAAAAAAAAAAAAAAAAAAABBB    AAAAAAAAAAAABB     AAAAAAAAAAAA     AAAAAA                              AAAAAAAAAAAAAAAAAAAAAAAAAAAAAAAAAAAAAA
AAAAAAAAAAAAAAAAAAAAAAAAAAAAAAAAAAAAAAAAAAAAAA        AAAAAAAA       AAAAAAAAAAAAB    AAAAAA                              AAAAAAAAAAAAAAAAAAAAAAAAAAAAAAAAAAAAAA
AAAAAAAAAAAAAAA                                       AAAAAAAA     BBAAAAAAAAAAAA     AAAAAA                              AAAAAAAAAAAAAAAAAAAAAAAAAAAAAAAAAAAAAA
AAAAAAAAAAAAAAA                                       AAAAAAAA       AAAAAAAAAAAABBBBBAAAAAA                              AAAAAAAAAAAAAAAAAAAAAAAAAAAAAAAAAAAAAA
AAAAAAAAAAAAAAA                                       AAAAAAAABB     AAAAAAAAAAAAAAAAAAAAAAA                              AAAAAAAAAAAAAAAAAAAAAAAAAAAAAAAAAAAAAA
AAAAAAAAAAAAAAA                                       AAAAAAAA       AAAAAAAAAAAAAAAAAAAAAAA                              AAAAAAAAAAAAAAAAAAAAAAAAAAAAAAAAAAAAAA
AAAAA                      BBB                        AAAAAAAA     BBAAAAAAAAAAAAAAAAAAAAAAA                              AAAAAAAAAAAAAAAAAAAAAAAAAAAAAAAAAAAAAA
AAAAA             B     BBBAAABBB                     AAAAAAAA       AAAAAAAAAAAAAAAAAAAAAAA                              AAAAAAAAAAAAAAAAAAAAAAAAAAAAAAAAAAAAAA
AAAAA      AAAA                      BBB    BBB       AAAAAAAABB     AAAAAAAAAAAAAAAAAAAAAAA                              AAAAAAAAAAAAAAAAAAAAAAAAAAAAAAAAAAAAAA
AAAAA      AAAA                BB                  BBBAAAAAAAA       AAAAAAAAAAAAAAAAAAAAAAA                              AAAAAAAAAAAAAAAAAAAAAAAAAAAAAAAAAAAAAA
AAAAA      AAAA                                    AAAAAAAAAAA     BBAAAAAAAAAAAAAAAAAAAAAAA                              AAAAAAAAAAAAAAAAAAAAAAAAAAAAAAAAAAAAAA
AAAAA      AAAA                                  BBAAAAAAAAAAA       AAAAAAAAAAAAAAAAAAAAAAA                              AAAAAAAAAAAAAAAAAAAAAAAAAAAAAAAAAAAAAA
AAAAA      AAAA                                  AAAAAAAAAAAAABB     AAAAAAAAAAAAAAAAAAAAAAA                              AAAAAAAAAAAAAAAAAAAAAAAAAAAAAAAAAAAAAA
AAAAA      AAAAAAAAAAAAAAAAAAAAAAAAAAAAAAAAAAAAAAAAAAAAAAAAAAA       AAAAAAAAAAAAAAAAAAAAAAA                              AAAAAAAAAAAAAAAAAAAAAAAAAAAAAAAAAAAAAA
AAAAA      AAAAAAAAAAAAAAAAAAAAAAAAAAAAAAAAAAAAAAAAAAAAAAAAAAA     BBAAAAAAAAAAAAAAAAAAAAAAA                              AAAAAAAAAAAAAAAAAAAAAAAAAAAAAAAAAAAAAA
AAAAA      AAAAAAAAAAAAAAAAAAAAAAAAAAAAAAAAAAAAAAAAAAAAAAAAAAA       AAAAAAAAAAAAAAAAAAAAAAA                              AAAAAAAAAAAAAAAAAAAAAAAAAAAAAAAAAAAAAA
AAAAA      AAAAAAAAAAAAAAAAAAAAAAAAAAAAAAAAAAAAAAAAAAAAAAAAAAABB     AAAAAAAAAAAAAAAAAAAAAAA                              AAAAAAAAAAAAAAAAAAAAAAAAAAAAAAAAAAAAAA
AAAAA                                                                AAAAAAAAAAAAAAAAAAAAAAA                              AAAAAAAAAAAAAAAAAAAAAAAAAAAAAAAAAAAAAA
AAAAA                                                              BBAAAAAAAAAAAAAAAAAAAAAAA                              AAAAAAAAAAAAAAAAAAAAAAAAAAAAAAAAAAAAAA
AAAAA                                                             BAAAAAAAAAAAAAAAAAAAAAAAAA                              AAAAAAAAAAAAAAAAAAAAAAAAAAAAAAAAAAAAAA
AAAAA                                                            BAAAAAAAAAAAAAAAAAAAAAAAAAA                              AAAAAAAAAAAAAAAAAAAAAAAAAAAAAAAAAAAAAA
AAAAAAAAAAAAAAAAAAAAAAAAAAAAAAAAAAAAAAAAAAAAAAAAAAAAAAAAAAAAAAAAAAAAAAAAAAAAAAAAAAAAAAAAAAAA                              AAAAAAAAAAAAAAAAAAAAAAAAAAAAAAAAAAAAAA